Aratama	あらたま
オオサワ	おおさわ
かなしま	かなしま
きのした	きのした
さいき	さいき
さいた	さいた
さいだ	さいだ
のざわ	のざわ
一の瀬	いちのせ
一ノ瀬	いちのせ
一丸	いちまる
一井	いちい
一力	いちりき
一場	いちば
一宮	いちのみや
一尾	いちお
一川	いちかわ
一木	いちき
一木	いっき
一村	いちむら
一条	いちじょう
一柳	いちやなぎ
一條	いちじょう
一森	いちもり
一見	かずみ
一谷	いちたに
丁野	ちょうの
七尾	ななお
七瀬	ななせ
七田	しちだ
万波	まんなみ
三上	みかみ
三井	みい
三井	みつい
三保	みほ
三原	みはら
三善	みよし
三塚	みつずか
三好	みよし
三宅	みやけ
三尾	みお
三岸	みぎし
三島	みしま
三戸	みと
三戸部	みとべ
三明	みあけ
三木	みき
三木原	みきはら
三村	みむら
三枝	さいぐさ
三枝	さえぐさ
三枝	みえだ
三池	みいけ
三沢	みさわ
三津原	みつはら
三津谷	みつや
三澤	みさわ
三田	みた
三田村	みたむら
三神	みかみ
三船	みふね
三輪	みわ
三野	みの
三門	みかど
三間	みま
三鬼	みき
三鷹	みたか
上原	うえはら
上原	かんばる
上垣	うえがき
上山	うえやま
上山	かみやま
上岡	かみおか
上廣	うえひろ
上杉	うえすぎ
上松	あげまつ
上條	かみじょう
上武	かみたけ
上江洲	うえず
上田	うえだ
上西	うえにし
上西	じょうにし
上野	うえの
下上	しもがみ
下保	かほ
下山	しもやま
下島	しもじま
下崎	しもざき
下田	しもだ
下西	しもにし
下野	しもの
不破	ふわ
与謝野	よさの
世古	せこ
世羅	せら
世良	せら
中井	なかい
中井川	なかいがわ
中代	なかだい
中倉	なかくら
中内	なかうち
中地	なかち
中塚	なかつか
中家	なかや
中岡	なかおか
中島	なかしま
中崎	なかざき
中嶋	なかしま
中平	なかひら
中新井	なかあらい
中本	なかもと
中杉	なかすぎ
中条	ちゅうじょう
中林	なかばやし
中桐	なかぎり
中條	なかじょう
中沢	なかざわ
中津川	なかつがわ
中浜	なかはま
中浦	なかうら
中澤	なかざわ
中濱	なかはま
中田	なかだ
中矢	なかや
中筋	なかすじ
中能島	なかのしま
中舘	なかだて
中西	なかにし
中辻	なかつじ
中込	なかごみ
中込	なかごめ
中里	なかざと
中馬	ちゅうま
丸井	まるい
丸尾	まるお
丸岡	まるおか
丸木	まるき
丸野	まるの
丹下	たんげ
丹波	たんば
丹野	たんの
丹野	にわの
久世	くぜ
久住	くすみ
久保	くぼ
久保倉	くぼくら
久保木	くぼき
久和原	くわはら
久坂部	くさかべ
久慈	くじ
久永	ひさなが
久田	ひさだ
久米	くめ
久野	くの
九条	くじょう
九鬼	くき
乾	いぬい
亀井	かめい
亀岡	かみおか
二上	ふたがみ
二宮	にのみや
二木	にき
二木	ふたき
二本柳	にほんやなぎ
二村	ふたむら
二橋	にはし
二田原	にたはら
二神	ふたがみ
二見	ふたみ
五十幡	いそはた
五味	ごみ
五島	ごしま
五島	ごとう
五月	さつき
五百籏頭	いおきべ
五藤	ごとう
五辻	いつつじ
井下	いのした
井並	いなみ
井入	いいり
井出	いで
井坂	いさか
井垣	いがき
井山	いやま
井崎	いざき
井川	いかわ
井川	いがわ
井手	いて
井手口	いでぐち
井本	いもと
井森	いもり
井沢	いざわ
井波	いなみ
井澤	いざわ
井田	いだ
井筒	いずつ
井草	いぐさ
井谷	いたに
井野	いの
京村	きょうむら
人見	ひとみ
仁平	にだいら
仁木	にき
仁科	にしな
今中	いまなか
今別府	いまべっぷ
今堀	いまほり
今川	いまがわ
今本	いまもと
今村	いまむら
今橋	いまはし
今泉	いまいずみ
今西	いまにし
今谷	いまたに
今里	いまざと
今野	こんの
仙石	せんごく
仲	なか
仲井	なかい
仲代	なかだい
仲咲	なかさき
仲川	なかがわ
仲田	なかだ
仲町	なかまち
仲西	なかにし
伊丹	いたみ
伊佐	いさ
伊原	いはら
伊吹	いぶき
伊地知	いちじ
伊差川	いさがわ
伊敷	いしき
伊澤	いざわ
伊狩	いかり
伊田	いだ
伊福部	いふくべ
伊賀	いが
伏見	ふしみ
会津	あいづ
伴野	ともの
住	すみ
住友	すみとも
住吉	すみよし
住山	すみやま
住本	すみもと
住田	すみだ
佐々井	ささい
佐々城	ささき
佐々木	ささき
佐々田	ささだ
佐久本	さくもと
佐久間	さくま
佐和	さわ
佐山	さやま
佐川	さがわ
佐怒賀	さぬか
佐村	さむら
佐瀬	させ
佐田	さた
佐田	さだ
佐竹	さたけ
佗美	たくみ
作間	さくま
依田	よだ
保坂	ほさか
保村	やすむら
保田	ほだ
保田	やすだ
保科	ほしな
保立	ほたて
信田	しだ
俵田	たわらだ
倉岡	くらおか
倉本	くらもと
倉沢	くらさわ
倉澤	くらさわ
倉田	くらた
倉石	くらいし
倉野	くらの
倉骨	くらほね
倭島	わじま
傳田	でんだ
元倉	もとくら
元田	もとだ
先崎	せんざき
光井	みつい
光安	みつやす
光岡	みつおか
児島	こじま
児嶋	こじま
児玉	こだま
入倉	いりくら
入山	いりやま
入江	いりえ
入沢	いりさわ
全田	ぜんだ
八代	やしろ
八島	やしま
八嶋	やしま
八巻	やまき
八幡	やはた
八木	やぎ
八木沼	やぎぬま
八津	やつ
八牧	やまき
八神	やがみ
八雲	やくも
八馬	はちうま
六塚	むつづか
六浦	むつうら
兵藤	ひょうどう
兵頭	ひょうどう
兼子	かねこ
兼清	かねきよ
内山	うちやま
内村	うちむら
内海	うつみ
内片	うちかた
内野	うちの
円谷	つぶらや
円谷	つむらや
冨水	とみみず
冨永	とみなが
冨澤	とみざわ
冨田	とみた
冴木	さえき
出村	でむら
出雲	いずも
初瀬	はつせ
別府	べっぷ
利根川	とねがわ
前原	まえはら
前嶋	まえじま
前川	まえかわ
前根	まえね
前田	まえた
前田	まえだ
副島	そえじま
功刀	くぬぎ
加世田	かせだ
加山	かやま
加島	かじま
加川	かがわ
加東	かとう
加毛	かも
加治	かじ
加瀬	かせ
加美	かみ
加茂	かも
加藤	かとお
加賀美	かがみ
加賀谷	かがや
加野	かの
加須屋	かすや
勝	かつ
勝亦	かつまた
勝山	かつやま
勝村	かつむら
勝野	かつの
北上	きたがみ
北原	きたはら
北口	きたくち
北口	きたぐち
北山	きたやま
北岡	きたおか
北島	きたじま
北川	きたかわ
北川	きたがわ
北条	ほうじょう
北森	きたもり
北沢	きたざわ
北澤	きたざわ
北田	きただ
北谷	きただに
北野	きたの
十返	とがえり
千田	せんだ
千田	ちだ
千種	ちぐさ
千輪	ちわ
升	ます
半田	はんだ
半谷	はんがい
南	みなみ
南原	なんばら
南川	みなみかわ
南波	なんば
南部	なんぶ
南里	なんり
南雲	なぐも
原	はら
原口	はらぐち
原島	はらしま
原藤	はらふじ
又吉	またよし
及川	おいかわ
友利	ともり
友永	ともなが
友田	ともだ
友野	ともの
友金	ともかね
反町	そりまち
受田	うけだ
古俣	こまた
古内	ふるうち
古城	こじょう
古場	こば
古屋	ふるや
古市	ふるいち
古庄	ふるしょう
古橋	ふるはし
古沢	ふるさわ
古泉	こいずみ
古澤	ふるさわ
古矢	ふるや
古茂田	こもだ
古藤	ことう
古谷	こや
古谷	ふるたに
古谷	ふるや
古谷野	こやの
古賀	こが
古野	ふるの
可児	かに
合屋	ごうや
合田	ごうだ
吉住	よしずみ
吉倉	よしくら
吉冨	よしとみ
吉原	よしはら
吉尾	よしお
吉崎	よしざき
吉川	きっかわ
吉川	よしかわ
吉森	よしもり
吉武	よしたけ
吉江	よしえ
吉沢	よしざわ
吉波	よしば
吉満	よしみつ
吉澤	よしざわ
吉積	よしづみ
吉見	よしみ
名倉	なぐら
名取	なとり
名越	なごや
向井	むかい
向後	こうご
向谷	むかいや
吹野	ふきの
吾妻	あずま
和久井	わくい
和気	わけ
和泉	いずみ
和田見	わだみ
善積	よしづみ
喜安	きやす
喜田村	きたむら
嘉戸	かど
四位	しい
四方	しかた
四方田	よもだ
国井	くにい
国分	こくぶ
国本	くにもと
國分	こくぶん
國弘	くにひろ
國枝	くにえだ
國重	くにしげ
園田	そのだ
園部	そのべ
土井	どい
土佐	とさ
土居	どい
土屋	つちや
土岐	とき
土平	つちひら
土橋	つちはし
土橋	どばし
土田	つちだ
土肥	どい
土肥	どひ
土谷	つちや
土門	どもん
坂上	さかうえ
坂上	さかがみ
坂井田	さかいだ
坂元	さかもと
坂口	さかぐち
坂川	さかがわ
坂巻	さかまき
坂本	さかもと
坂野	さかの
坪井	つぼい
坪内	つぼうち
垣内	かきうち
垣添	かきぞえ
城	じょう
城内	きうち
城戸	きど
城福	じょうふく
城野	じょうの
城間	しろま
堀	ほり
堀之内	ほりのうち
堀井	ほりい
堀内	ほりうち
堀切	ほりきり
堀北	ほりきた
堀口	ほりぐち
堀場	ほりば
堀岡	ほりおか
堀川	ほりかわ
堀江	ほりえ
堀田	ほった
堀辺	ほりべ
堀野	ほりの
堂林	どうばやし
堤	つつみ
堺田	さかいだ
塚原	つかはら
塚本	つかもと
塚田	つかだ
塚越	つかごし
塩出	しおで
塩原	しおばら
塩山	しおやま
塩崎	しおざき
塩川	しおかわ
塩沢	しおざわ
塩谷	しおたに
塩野	しおの
境	さかい
増井	ますい
増山	ますやま
増岡	ますおか
増沢	ますざわ
増野	ますの
增田	ますだ
夏井	なつい
夏川	なつかわ
外山	とやま
外岡	とのおか
外崎	とのさき
外村	とのむら
外間	ほかま
多湖	たご
多田	ただ
多賀	たが
大下	おおした
大亀	おおかめ
大伴	おおとも
大住	おおすみ
大倉	おおくら
大内	おおうち
大出	おおいで
大前	おおまえ
大北	おおきた
大原	おおはら
大友	おおとも
大口	おおぐち
大和	やまと
大和田	おおわだ
大園	おおぞの
大地	たいち
大垣	おおがき
大城	おおき
大城	おおしろ
大堀	おおほり
大場	おおば
大塩	おおしお
大宅	おおや
大室	おおむろ
大宮	おおみや
大家	おおいえ
大岡	おおおか
大岩	おおいわ
大島	おおしま
大崎	おおさき
大嶽	おおたけ
大庭	おおば
大庭	おば
大戸	おおと
大月	おおつき
大木	おおき
大本	おおもと
大杉	おおすぎ
大村	おおむら
大林	おうばやし
大林	おおばやし
大枝	おおえだ
大栗	おおぐり
大森	おおもり
大槻	おおつき
大橋	おおはし
大武	おおたけ
大江	おおえ
大沢	おおさわ
大河	たいが
大河内	おおこうち
大沼	おおぬま
大泉	おおいずみ
大津	おおつ
大津留	おおつる
大浜	おおはま
大渡	おおわたり
大滝	おおたき
大澤	おおさわ
大畑	おおはた
大矢	おおや
大石	おいし
大竹	おおたけ
大竹	おたけ
大脇	おおわき
大蔵	おおくら
大西	おおにし
大貫	おおぬき
大賀	おおが
大越	おおこし
大迫	おおさこ
大道	おおみち
大里	おおさと
大門	だいもん
大関	おおぜき
大隅	おおすみ
大須賀	おおすが
大駒	おおこま
大鳥	おおとり
大鷹	おおたか
天埜	あまの
天宅	あまやけ
天川	あまかわ
天津	あまつ
天谷	あまや
天野	あまの
太刀川	たちかわ
太宰	だざい
奈良	なら
奈良崎	ならざき
奈良林	ならばやし
奈須	なす
奥	おく
奥井	おくい
奥原	おくはら
奥山	おくやま
奥平	おくだいら
奥田	おくだ
奥谷	おくたに
奥野	おくの
如月	きさらぎ
妙木	みょうき
妹尾	せお
妹尾	せのお
姫野	ひめの
宇井	うい
宇佐美	うさみ
宇佐見	うさみ
宇南山	うなやま
宇多村	うたむら
宇山	うやま
宇沢	うざわ
宇津木	うつき
宇田	うだ
宇田川	うたがわ
宇留野	うるの
宇都宮	うつのみや
宇野	うの
宇高	うたか
守山	もりやま
守岡	もりおか
守田	もりた
安井	やすい
安原	やすはら
安宅	あたか
安岡	やすおか
安島	あじま
安川	やすかわ
安斉	あんざい
安斎	あんざい
安本	やすもと
安村	やすむら
安東	あんどう
安永	やすなが
安田	やすだ
安西	あんざい
安辺	あべ
安達	あだち
安里	あさと
宍倉	ししくら
宗	そう
宗像	むなかた
宗田	そうだ
定金	さだかね
宝月	ほうげつ
宝田	たからだ
宝田	ほうだ
室伏	むろふし
室伏	むろぶし
室屋	むろや
室岡	むろおか
室谷	むろや
宮	みや
宮下	みやした
宮井	みやい
宮内	みやうち
宮地	みやじ
宮坂	みやさか
宮城	みやぎ
宮尾	みやお
宮岡	みやおか
宮崎	みやざき
宮川	みやかわ
宮川	みやがわ
宮本	みやもと
宮武	みやたけ
宮永	みやなが
宮沢	みやざわ
宮浦	みやうら
宮澤	みやざわ
宮瀬	みやせ
宮田	みやた
宮脇	みやわき
宮腰	みやこし
宮西	みやにし
宮越	みやこし
宮迫	みやさこ
宮道	みやみち
宮里	みやざと
宮野	みやの
家富	いえとみ
富塚	とみずか
富張	とみはり
富樫	とがし
富永	とみなが
富沢	とみざわ
富澤	とみさわ
富澤	とみざわ
富田	とみた
寒川	かんかわ
寒川	さんがわ
寒河江	さがえ
寺井	てらい
寺内	てらうち
寺地	てらじ
寺地	てらち
寺尾	てらお
寺山	てらやま
寺峰	てらみね
寺島	てらしま
寺崎	てらさき
寺崎	てらざき
寺田	てらだ
寺西	てらにし
寺谷	てらたに
寺門	てらかど
寿岳	じゅがく
小中	こなか
小久保	こくぼ
小俣	おまた
小出	こいで
小原	おはら
小原	おばら
小原	こはら
小口	おぐち
小向	こむかい
小和田	おわだ
小坂	こさか
小坂田	おさかだ
小城	おじろ
小堀	こぼり
小場	こば
小塚	こずか
小室	こむろ
小宮	こみや
小宮山	こみやま
小山内	おさない
小山田	おやまた
小山田	おやまだ
小岩井	こいわい
小岩屋	こいわや
小岸	こぎし
小峯	こみね
小峰	こみね
小島	おじま
小島	こじま
小嶋	こじま
小嶌	こじま
小嶺	こみね
小幡	おばた
小幡	こばた
小平	こだいら
小方	おがた
小杉	こすぎ
小松	こまつ
小柴	こしば
小栗	おぐり
小森	こもり
小森園	こもりぞの
小橋	こばし
小此木	おこのぎ
小池	こいけ
小沢	こざわ
小河	おがわ
小沼	おぬま
小沼	こぬま
小津	おづ
小深田	こぶかた
小渕	おぶち
小滝	こたき
小澤	おざわ
小瀬	おぜ
小熊	おぐま
小牟田	こむた
小玉	こだま
小田倉	おだくら
小田切	おだぎり
小田原	おだわら
小田柿	おだがき
小田桐	おだぎり
小町	こまち
小町谷	こまちや
小畑	おばた
小石	こいし
小磯	こいそ
小礒	こいそ
小穴	おあな
小竹	こたけ
小竹	さたけ
小笠原	おがさわら
小篠	こしの
小美野	こみの
小西	こにし
小谷	こたに
小谷	こだに
小貫	おぬき
小路	こうじ
小里	おざと
小野川	おのがわ
小野木	おのぎ
小野村	おのむら
小野沢	おのざわ
小野田	おのだ
小長谷	こながや
小門	こかど
小関	こせき
小阪	こさか
小高	おだか
小高	こたか
尼崎	あまさき
尾﨑	おざき
尾上	おのうえ
尾島	おじま
尾沢	おざわ
尾畑	おばた
尾留川	びるかわ
尾花	おばな
尾関	おぜき
屋敷	やしき
山内	やまうち
山内	やまのうち
山北	やまきた
山室	やまむろ
山岸	やまぎし
山形	やまがた
山木	やまき
山村	やまむら
山東	さんとう
山根	やまね
山沢	やまざわ
山浦	やまうら
山登	やまと
山科	やましな
山縣	やまがた
山脇	やまわき
山西	やまにし
山路	やまじ
山部	やまべ
山里	やまさと
山際	やまぎわ
山高	やまたか
岡	おか
岡井	おかい
岡口	おかぐち
岡和田	おかわだ
岡島	おかじま
岡崎	おかざき
岡庭	おかにわ
岡村	おかむら
岡林	おかばやし
岡部	おかべ
岩﨑	いわさき
岩上	いわかみ
岩下	いわした
岩井	いわい
岩佐	いわさ
岩倉	いわくら
岩元	いわもと
岩出	いわで
岩城	いわき
岩城	いわしろ
岩尾	いわお
岩崎	いわさき
岩川	いわかわ
岩月	いわつき
岩木	いわき
岩本	いわもと
岩根	いわね
岩槻	いわつき
岩橋	いわはし
岩永	いわなが
岩波	いわなみ
岩淵	いわぶち
岩渕	いわぶち
岩瀬	いわせ
岩田	いわた
岩谷	いわや
岩野	いわの
岩間	いわま
岳野	たけの
岸本	きしもと
岸野	きしの
峰	みね
島崎	しまざき
島川	しまかわ
島村	しまむら
島津	しまづ
島谷	しまたに
嶋崎	しまざき
嶋野	しまの
川﨑	かわさき
川上	かわかみ
川下	かわもと
川井	かわい
川俣	かわまた
川元	かわもと
川内	かわうち
川勝	かわかつ
川北	かわきた
川原	かわはら
川又	かわまた
川合	かわい
川守田	かわもりた
川尻	かわじり
川嶋	かわしま
川手	かわて
川本	かわもと
川満	かわみつ
川瀬	かわせ
川田	かわた
川田	かわだ
川畑	かわばた
川端	かわばた
川西	かわにし
川越	かわごえ
川野	かわの
工藤	くどう
左東	さとう
左藤	さとう
巽	たつみ
市ノ瀬	いちのせ
市丸	いちまる
市井	いちい
市原	いちはら
市村	いちむら
市来	いちき
市橋	いちはし
市田	いちだ
布施	ふせ
帆足	ほあし
常田	ときた
常盤	ときわ
幡谷	はたや
幡野	はたの
平	たいら
平下	ひらした
平井	ひらい
平口	ひらぐち
平塚	ひらつか
平尾	ひらお
平山	ひらやま
平岡	ひらおか
平岩	ひらいわ
平島	ひらしま
平島	ひらじま
平川	ひらかわ
平木	ひらき
平本	ひらもと
平松	ひらまつ
平林	ひらばやし
平沢	ひらさわ
平沼	ひらぬま
平澤	ひらさわ
平石	ひらいし
平賀	ひらが
平間	ひらま
幸田	こうだ
幸田	こおだ
広中	ひろなか
広島	ひろしま
広川	ひろかわ
広江	ひろえ
広瀬	ひろせ
広田	ひろた
広畑	ひろはた
広谷	ひろたに
庄司	しょうじ
庄子	しょうじ
庄野	しょうの
床波	とこなみ
庭田	にわた
廣上	ひろかみ
廣江	ひろえ
廣瀬	ひろせ
廣田	ひろた
廣道	ひろみち
廣部	ひろべ
廣野	ひろの
延江	のぶえ
弓削	ゆげ
引地	ひきち
張田	はりた
影山	かげやま
影平	かげひら
徳	とく
徳井	とくい
徳光	とくみつ
徳安	とくやす
徳山	とくやま
徳川	とくがわ
徳永	とくなが
徳江	とくえ
徳澤	とくざわ
徳田	とくだ
徳留	とくどめ
徳野	とくの
德丸	とくまる
志垣	しがき
志水	しみず
志賀	しが
恒岡	つねおか
惠木	えぎ
愛知	あいち
慶野	けいの
成沢	なるさわ
成瀬	なるせ
我妻	わがつま
戒田	かいだ
戸井	とい
戸島	としま
戸島	とじま
戸川	とがわ
戸本	ともと
戸村	とむら
戸沢	とざわ
戸田	とだ
戸谷	とたに
戸谷	とや
戸部	とべ
手塚	てずか
手塚	てつか
手島	てしま
才藤	さいとう
才賀	さいが
折井	おりい
折原	おりはら
折橋	おりはし
折笠	おりかさ
押本	おしもと
捧	ささげ
掛川	かけがわ
揖斐	いび
播磨	はりま
政田	まさだ
斉田	さいた
斉田	さいだ
斉藤	さいとう
斎田	さいた
新	あらた
新タ	にった
新保	しんぼ
新原	にいはら
新垣	あらがき
新垣	にいがき
新宅	しんたく
新屋	しんや
新山	にいやま
新島	にいじま
新崎	あらさき
新川	あらかわ
新庄	しんじょう
新條	しんじょう
新海	しんかい
新玉	あらたま
新田	あらた
新田	にった
新美	しんみ
新藤	しんどう
新谷	しんたに
新道	しんどう
新里	しんざと
新野	にいの
新開	しんかい
日下	くさか
日下部	くさかべ
日原	ひはら
日吉	ひよし
日向	ひなた
日向	ひゅうが
日暮	ひぐらし
日比	ひび
日浦	ひうら
日笠	ひがさ
日野石	ひのいし
早乙女	さおとめ
早坂	はやさか
早崎	はやさき
早嶋	はやしま
早川	はやかわ
早河	はやかわ
早田	そうだ
早見	はやみ
早野	はやの
旭	あさひ
明坂	あけさか
明本	あけもと
明田	あけた
明田	あけだ
明石	あかいし
明石	あかし
星	ほし
星乃	ほしの
星合	ほしあい
星埜	ほしの
星山	ほしやま
星川	ほしかわ
星田	ほしだ
春口	はるぐち
春名	はるな
春山	はるやま
春日	かすが
春日	はるか
春日井	かすがい
春木	はるき
是永	これなが
晝田	ひるた
普久原	ふくはら
景山	かげやま
曽我	そが
曽根	そね
最上	もがみ
會田	あいた
月岡	つきおか
有光	ありみつ
有坂	ありさか
有山	ありやま
有川	ありかわ
有明	ありあけ
有本	ありもと
有村	ありむら
有松	ありまつ
有江	ありえ
有田	ありた
有藤	ありとう
有賀	あるが
有馬	ありま
望月	もちづき
朝岡	あさおか
朝野	あさの
朝長	ともなが
木下	きした
木佐貫	きさぬき
木内	きうち
木原	きはら
木宮	きみや
木實	このみ
木山	きやま
木嶋	きじま
木川	きがわ
木幡	こはた
木幡	こばた
木庭	きば
木澤	きさわ
木澤	きざわ
木田	きだ
木藤	きとう
木谷	きたに
木間	きま
末包	すえかね
末吉	すえよし
末川	すえかわ
末広	すえひろ
末弘	すえひろ
末木	すえき
末本	すえもと
末松	すえまつ
末永	すえなが
末田	すえだ
本山	もとやま
本川	もとかわ
本庄	ほんじょう
本村	もとむら
本橋	もとはし
本田	ほんだ
本郷	ほんごう
本間	ほんま
杉全	すぎまた
杉原	すぎはら
杉山	すぎやま
杉崎	すぎさき
杉村	すぎむら
杉江	すぎえ
杉谷	すぎたに
杉野	すぎの
村中	むらなか
村主	すぐり
村元	むらもと
村尾	むらお
村山	むらやま
村岡	むらおか
村嶋	むらしま
村本	むらもと
村松	むらまつ
村林	むらばやし
村椿	むらつばき
村沢	むらさわ
村瀬	むらせ
村越	むらこし
村野	むらの
東	あづま
東	ひがし
東出	ひがしで
東山	ひがしやま
東海林	しょうじ
東海林	とうかいりん
東野	ひがしの
松下	まつした
松井	まつい
松元	まつもと
松南	まつなみ
松友	まつとも
松坂	まつざか
松山	まつやま
松島	まつしま
松嶋	まつしま
松川	まつかわ
松平	まつだいら
松延	まつのぶ
松方	まつかた
松月	まつづき
松木	まつき
松村	まつむら
松林	まつばやし
松森	まつもり
松永	まつなが
松江	まつえ
松沢	まつざわ
松波	まつなみ
松浦	まつうら
松澤	まつざわ
松濤	まつなみ
松阪	まつざか
松雪	まつゆき
松風	まつかぜ
板倉	いたくら
板坂	いたさか
板東	ばんどう
板谷	いたや
林家	はやしや
林田	はやしだ
柄沢	からさわ
柏	かしわ
柏原	かしはら
柏原	かしわばら
柏村	かしわむら
柏田	かしわだ
柏谷	かしわだに
柏野	かしの
染矢	そめや
染谷	そめたに
染谷	そめや
柘植	つげ
柚木	ゆずき
柳	やなぎ
柳下	やぎした
柳井	やない
柳原	やなぎはら
柳川	やながわ
柳本	やなぎもと
柳橋	やなぎはし
柳沢	やなぎさわ
柳沼	やぎぬま
柳澤	やなぎさわ
柳澤	やなぎざわ
柳瀬	やなせ
柳父	やなぶ
柳生	やぎゅう
柳田	やなぎた
柳田	やなぎだ
柳谷	やなぎたに
柳谷	やなぎや
柴	しば
柴原	しばはら
柴山	しばやま
柴崎	しばさき
柴本	しばもと
柿崎	かきざき
柿木	かきのき
柿本	かきもと
栂野尾	とがのお
栖原	すはら
栗原	くりはら
栗城	くりき
栗山	くりやま
根木	ねき
根木	ねぎ
根本	ねもと
根来	ねごろ
桂	かつら
桂川	かつらがわ
桃井	ももい
桐山	きりやま
桑原	くわはら
桑原	くわばら
桑山	くわやま
桑島	くわしま
桑田	くわた
桜井	さくらい
桜庭	さくらば
桜樹	さくらぎ
桜田	さくらだ
桶谷	おけたに
桶谷	おけや
梁田	やなだ
梅原	うめはら
梅山	うめやま
梅木	うめき
梅村	うめむら
梅森	うめもり
梅沢	うめざわ
梅津	うめず
梅津	うめつ
梅澤	うめざわ
梅田	うめだ
梶井	かじい
梶原	かじはら
梶原	かじわら
梶浦	かじうら
梶田	かじた
棟田	むねた
森下	もりした
森井	もりい
森口	もりぐち
森園	もりぞの
森地	もりち
森岡	もりおか
森島	もりしま
森崎	もりさき
森木	もりき
森本	もりもと
森村	もりむら
森永	もりなが
森沢	もりさわ
森脇	もりわき
森若	もりわか
森谷	もりたに
森野	もりの
植木	うえき
植村	うえむら
植林	うえばやし
植田	うえた
植田	うえだ
植竹	うえたけ
植草	うえくさ
植野	うえの
椎名	しいな
椎野	しいな
椎野	しいの
椙山	すぎやま
椿	つばき
楠原	くすはら
楠木	くすのき
楠本	くすもと
楠田	くすだ
楢原	ならはら
楢崎	しのざき
楢崎	ならさき
楢橋	ならはし
榊山	さかきやま
榎	えのき
榎本	えのもと
槙野	まきの
樋口	ひぐち
樋川	といかわ
権田	ごんだ
権藤	ごんどう
横塚	よこつか
横尾	よこお
横川	よこかわ
横張	よこはり
横沢	よこさわ
横溝	よこみぞ
横谷	よこたに
横関	よこぜき
樫原	かしはら
樫崎	かしざき
樫村	かしむら
樫田	かしだ
樽野	たるの
橋	はし
橋井	はしい
橋口	はしぐち
橋川	はしかわ
橋爪	はしずめ
橋爪	はしづめ
橋詰	はしずめ
橘	たちばな
橘田	きった
櫛田	くしだ
櫻井	さくらい
櫻木	さくらぎ
櫻本	さくらもと
櫻田	さくらだ
正司	しょうじ
正宗	まさむね
正富	まさとみ
正岡	まさおか
正木	ただき
正田	しょうだ
武井	たけい
武内	たけのうち
武居	たけい
武島	たけしま
武智	たけち
武石	たけいし
武藤	むとう
武谷	たけや
武部	たけべ
毒島	ぶすじま
比企	ひき
比嘉	ひが
比留間	ひるま
毛利	もうり
氏原	うじはら
水上	みずかみ
水之江	みずのえ
水井	みずい
水元	みずもと
水原	みずはら
水口	みずぐち
水品	みずしな
水城	みずき
水尾	みずお
水嶋	みずしま
水嶋	みづしま
水川	みながわ
水戸	みと
水戸岡	みとおか
水戸部	みとべ
水月	みづき
水木	みずき
水本	みづもと
水村	みずむら
水林	みずばやし
水森	みなもり
水樹	みずき
水江	みずえ
水沢	みずさわ
水沼	みずぬま
水津	すいず
水津	すいづ
水澤	みずさわ
水瀬	みずせ
水瀬	みなせ
水田	みずた
水町	みずまち
水落	みずおち
水谷	みずたに
水越	みずこし
水間	みずま
永	えい
永江	ながえ
永沢	ながさわ
永瀬	ながせ
永野	ながの
江上	えがみ
江利川	えりかわ
江原	えはら
江原	えばら
江口	えぐち
江夏	えなつ
江尻	えじり
江島	えじま
江崎	えさき
江崎	えざき
江川	えがわ
江幡	えばた
江木	えぎ
江村	えむら
江沢	えざわ
江波戸	えばと
江淵	えぶち
江田	えだ
江田	こうだ
江花	えばな
江藤	えとう
江見	えみ
江間	えま
江頭	えがしら
池	いけ
池内	いけうち
池崎	いけざき
池川	いけがわ
池本	いけもと
池森	いけもり
池永	いけなが
池田	いけだ
池畠	いけはた
池端	いけはた
池端	いけばた
池脇	いけわき
池見	いけみ
池谷	いけたに
池間	いけま
沖	おき
沖本	おきもと
沖田	おきた
沖野	おきの
沙月	さつき
沢	さわ
沢井	さわい
沢口	さわぐち
沢木	さわき
沢村	さわむら
沢田	さわだ
河上	かわかみ
河井	かわい
河内	かわうち
河内	かわち
河内	こうち
河出	かわで
河原	かわはら
河口	かわぐち
河合	かわい
河島	かわしま
河崎	かわさき
河本	かわもと
河本	こうもと
河村	かわむら
河東田	かとうだ
河津	かわづ
河田	かわた
河田	かわだ
河端	かわばた
河西	かさい
河角	かわすみ
河邑	かわむら
河野	かわの
河野	こうの
油谷	あぶらや
沼尻	ぬまじり
沼崎	ぬまざき
沼川	ぬまかわ
沼田	ぬまた
泉	いずみ
泉川	いずみかわ
泉沢	いずみさわ
泉田	いずた
泉谷	いずみたに
泊	とまり
波多野	はたの
波夛野	はたの
波田野	はたの
波間	はま
津上	つがみ
津山	つやま
津島	つしま
津川	つがわ
津曲	つまがり
津村	つむら
津留	つる
津野	つの
浄野	きょの
浅井	あさい
浅倉	あさくら
浅利	あさり
浅原	あさはら
浅尾	あさお
浅岡	あさおか
浅島	あさしま
浅川	あさかわ
浅沼	あさぬま
浅海	あさみ
浅田	あさだ
浅野	あさの
浜下	はました
浜中	はまなか
浜島	はましま
浜島	はまじま
浜崎	はまさき
浜川	はまかわ
浜本	はまもと
浜村	はまむら
浜田	はまだ
浜谷	はまや
浜野	はまの
浜野	はまや
浦	うら
浦上	うらかみ
浦上	うらがみ
浦井	うらい
浦崎	うらさき
浦川	うらかわ
浦田	うらた
浪花	なにわ
浮田	うきだ
海保	かいほ
海老名	えびな
海老根	えびね
海野	うみの
海野	うんの
涌田	わくた
淀	よど
深井	ふかい
深尾	ふかお
深山	みやま
深沢	ふかざわ
深津	ふかず
深津	ふかつ
深澤	ふかさわ
深澤	ふかざわ
深瀬	ふかせ
深田	ふかだ
深町	ふかまち
深見	ふかみ
深谷	ふかたに
深谷	ふかや
深野	ふかの
添島	そえじま
清原	きよはら
清宮	せいみや
清家	せいけ
清川	きよかわ
清成	きよなり
清武	きよたけ
清浦	きようら
清藤	きよふじ
渋沢	しぶさわ
渋谷	しぶや
渡久山	とくやま
渡瀬	わたせ
渡邉	わたなべ
渡部	わたべ
渥美	あつみ
湊谷	みなとや
湯山	ゆやま
湯川	ゆかわ
湯本	ゆもと
湯沢	ゆざわ
湯浅	ゆあさ
満井	みつい
満園	みつぞの
満山	みつやま
源	みなもと
溝口	みぞくち
溝口	みぞぐち
溝尾	みぞお
溝渕	みぞぶち
滝井	たきい
滝川	たきがわ
滝本	たきもと
滝沢	たきざわ
滝澤	たきさわ
滝澤	たきざわ
滝田	たきた
潮	うしお
潮田	しおた
澄田	すみた
澤	さわ
澤井	さわい
澤木	さわき
澤村	さわむら
澤田	さわだ
澤野	さわの
濱口	はまぐち
濱田	はまだ
濵田	はまだ
瀧川	たきがわ
瀧本	たきもと
瀧澤	たきざわ
瀧野	たきの
瀬古	せこ
瀬尾	せお
瀬川	せがわ
瀬戸	せと
瀬戸山	せとやま
瀬木	せぎ
瀬沢	せざわ
瀬良	せら
瀬谷	せや
瀬野	せの
火口	ひぐち
烏田	からすだ
熊坂	くまさか
熊川	くまかわ
熊木	くまき
熊沢	くまざわ
熊澤	くまざわ
熊田	くまだ
熊野	くまの
熱田	あつた
片倉	かたくら
片桐	かたぎり
片瀨	かたせ
片瀬	かたせ
片野	かたの
牛尾	うしお
牛窪	うしくぼ
牟田	むた
牧原	まきはら
牧村	まきむら
牧田	まきた
牧野	まきの
犬丸	いぬまる
犬塚	いぬずか
犬塚	いぬづか
犬飼	いぬかい
狭川	さがわ
猪俣	いのまた
猪又	いのまた
猪瀬	いのせ
猪狩	いかり
猪狩	いがり
玉井	たまい
玉城	たまき
玉塚	たまつか
玉川	たまがわ
玉木	たまき
玉田	たまだ
玉置	たまおき
玉置	たまき
玉野	たまの
琴音	ことね
瑞木	みずき
瓜生原	うりゅうはら
甘利	あまり
生井澤	なまいざわ
生島	いくしま
生形	おがた
生方	うぶかた
生沢	いくざわ
生沢	うぶさわ
生田	いくた
生田	しょうだ
生田目	なまため
生野	いくの
田上	たがみ
田代	たしろ
田仲	たなか
田児	たご
田原	たばら
田口	たぐち
田和	たわ
田坂	たさか
田岡	たおか
田島	たじま
田崎	たさき
田崎	たざき
田嶋	たじま
田巻	たまき
田平	たびら
田所	たどころ
田林	たばやし
田沢	たざわ
田沼	たぬま
田浦	たうら
田渕	たぶち
田澤	たざわ
田畑	たばた
田端	たばた
田辺	たなべ
田邊	たなべ
田阪	たさか
田鶴浜	たづはま
由田	よしだ
由良	ゆら
甲斐田	かいだ
甲田	こうだ
甲野	こうの
町井	まちい
町田	まちだ
畑	はた
畑中	はたなか
畑尾	はたお
畑山	はたやま
畔柳	くろやなぎ
畠中	はたなか
番場	ばんば
疋田	ひきた
登坂	のぼりさか
白井	しらい
白坂	しらさか
白山	しろやま
白岩	しらいわ
白川	しらかわ
白木	しらき
白木	しろき
白柳	しろやなぎ
白田	しらた
白石	しらいし
白神	しらが
白神	しらがみ
白鳥	しらとり
百地	ももち
百瀬	ももせ
皆藤	かいとう
益田	ますだ
盛内	もりうち
目加田	めかだ
目黒	めぐろ
直井	なおい
直江	なおえ
相原	あいはら
相川	あいかわ
相方	あいかた
相沢	あいざわ
相澤	あいざわ
相田	あいだ
眞田	さなだ
真下	ました
真中	まなか
真仲	まなか
真島	ましま
真崎	しんざき
真崎	まさき
真庭	まにわ
真田	さなだ
真辺	まなべ
真部	まなべ
真野	まの
真野	まや
真鍋	まなべ
矢代	やしろ
矢作	やはぎ
矢内	やうち
矢内	やない
矢口	やぐち
矢吹	やぶき
矢尾	やお
矢島	やじま
矢崎	やざき
矢嶋	やじま
矢幡	やはた
矢村	やむら
矢樹	やぎ
矢田	やた
矢田	やだ
矢部	やべ
矢野	やの
知念	ちねん
石	いし
石丸	いしまる
石井	いしい
石原	いしはら
石塚	いしづか
石山	いしやま
石岡	いしおか
石本	いしもと
石村	いしむら
石渡	いしわた
石渡	いしわたり
石澤	いしざわ
石神	いしがみ
石福	いしふく
石野	いしの
砂原	さはら
砂田	すなだ
碇	いかり
碓井	うすい
磐井	いわい
磯	いそ
磯原	いそはら
磯山	いそやま
磯崎	いぞざき
磯村	いそむら
磯矢	いそや
磯谷	いそがい
磯貝	いそがい
磯辺	いそべ
磯部	いそべ
磯野	いその
祖父江	そぶえ
祝	いわい
神	じん
神井	かみい
神保	じんぼ
神前	かんざき
神尾	かみお
神山	かみやま
神山	こうやま
神崎	かんざき
神戸	かんべ
神木	かみき
神林	かんばやし
神津	こうず
神田	こうだ
神野	かみの
神野	しんの
福井	ふくい
福元	ふくもと
福原	ふくはら
福富	ふくとみ
福富	よしとみ
福尾	ふくお
福山	ふくやま
福島	ふくしま
福川	ふくかわ
福本	ふくもと
福村	ふくむら
福森	ふくもり
福武	ふくたけ
福永	ふくなが
福江	ふくえ
福澤	ふくざわ
福王	ふくおう
福田	ふくだ
福留	ふくどめ
福西	ふくにし
福間	ふくま
秋元	あきもと
秋光	あきみつ
秋吉	あきよし
秋山	あきやま
秋本	あきもと
秋武	あきたけ
秋澤	あきざわ
秋田	あきた
秋葉	あきば
秋野	あきの
秦	はた
秦野	はたの
種田	おいた
稲上	いながみ
稲井	いない
稲垣	いながき
稲富	いなとみ
稲川	いながわ
稲本	いなもと
稲村	いなむら
稲森	いなもり
稲田	いなだ
稲葉	いなば
穂坂	ほさか
穂積	ほづみ
積田	つみた
穴井	あない
空下	そらした
窪寺	くぼでら
立原	たちはら
立川	たちかわ
立川	たつかわ
立川	たてかわ
立木	たちき
立松	たてまつ
立花	たちばな
立野	たての
竜田	たつた
竪山	たてやま
端	はた
竹之内	たけのうち
竹井	たけい
竹元	たけもと
竹內	たけうち
竹前	たけまえ
竹尾	たけお
竹屋	たけや
竹山	たけやま
竹本	たけもと
竹林	たけばやし
竹澤	たけざわ
竹脇	たけわき
竹谷	たけたに
竹谷	たけや
竹野	たけの
竹間	ちくま
笈川	おいかわ
笛田	ふえだ
笠	りゅう
笠井	かさい
笠原	かさはら
笠木	かさぎ
笠間	かさま
笹倉	ささくら
笹原	ささはら
笹川	ささがわ
笹木	ささき
笹本	ささもと
笹沼	ささぬま
笹渕	ささぶち
笹田	ささだ
筈見	はずみ
等力	とりき
筒井	つつい
筧	かけひ
築島	つきしま
篠原	しのはら
篠塚	しのずか
篠宮	しのみや
篠崎	しのざき
篠田	しのだ
篠藤	しのとう
簗瀬	やなせ
米	よね
米倉	よねくら
米元	よねもと
米原	よねはら
米山	よねやま
米川	よねかわ
米村	よねむら
米沢	よねざわ
米津	よねつ
米澤	よねざわ
米田	よねだ
米谷	よねや
米野	よねの
籾山	もみやま
粂田	くめた
粉川	こがわ
粕谷	かすや
粟山	もみやま
粟津	あわつ
粟津	あわづ
糟谷	かすたに
糸川	いとかわ
糸賀	いとが
納富	のうとみ
純名	じゅんな
細木	ほそき
細谷	ほそや
紺谷	こんたに
紺野	こんの
結城	ゆうき
続木	つづき
網本	あみもと
綿矢	わたや
綿谷	わたたに
綿貫	わたぬき
緑川	みどりかわ
緒川	おがわ
織田	おりた
美保	みほ
美尾	みお
美川	みかわ
美東	みとう
美濃	みの
美里	みさと
羽仁	はに
羽場	はば
羽生	はにゅう
羽田	はかた
羽田	はだ
羽田	はねだ
羽田野	はだの
羽石	はねいし
羽藤	はとう
羽鳥	はとり
聴濤	きくなみ
肥田	ひだ
能代	のしろ
能島	のじま
脇坂	わきさか
脇田	わきた
臺	うてな
臼井	うすい
臼木	うすき
臼田	うすだ
與那覇	よなは
舘	たち
舘	たて
舘石	たていし
舛森	ますもり
舛田	ますだ
舟山	ふなやま
舟木	ふなき
舟橋	ふなはし
船山	ふなやま
船戸	ふなと
船木	ふなき
船橋	ふなはし
船津	ふなつ
船田	ふなだ
船越	ふなこし
良田	よしだ
芝	しば
芝原	しばはら
芝田	しばた
芥川	あくたがわ
芦原	あしはら
芦川	あしかわ
芦田	あしだ
花井	はない
花山	はなやま
花岡	はなおか
花島	はなしま
花島	はなじま
花房	はなぶさ
花村	はなむら
花沢	はなざわ
花田	はなだ
花輪	はなわ
花野	はなの
芹川	せりかわ
芹沢	せりざわ
芹澤	せりざわ
若尾	わかお
若山	わかやま
若月	わかつき
若杉	わかすぎ
若松	わかまつ
若林	わかばやし
若槻	わかつき
苧木	おぎ
苫米地	とまべち
苫野	とまの
茂木	しげき
茂田	しげた
茨木	いばらき
茶谷	ちゃたに
草地	くさち
草場	くさば
草柳	くさやなぎ
草野	くさの
荻原	おぎはら
荻原	おぎわら
荻田	おぎた
荻野	おぎの
菅	かん
菅	すが
菅	すげ
菅原	すがはら
菅原	すがわら
菅川	すげかわ
菅沼	すがぬま
菅生	すごう
菅田	すがた
菅谷	すがや
菅野	すがの
菊原	きくはら
菊田	きくた
菊盛	きくもり
菊竹	きくたけ
菊谷	きくたに
菊谷	きくや
菊野	きくの
華園	はなぞの
菱川	ひしかわ
菱田	ひしだ
萩原	はぎはら
萩原	はぎわら
萩本	はぎもと
萩田	はぎた
萩谷	はぎたに
萩野	はぎの
萬歳	ばんざい
萬行	まんぎょう
萬谷	まんたに
落合	おちあい
葛岡	くずおか
葛西	かさい
葭田	よしだ
蒔田	まきた
蒲生	がもう
蒼井	あおい
蓑輪	みのわ
蓮沼	はすぬま
蔦田	つただ
蔭山	かげやま
蔵本	くらもと
蔵田	くらた
薄井	うすい
薗田	そのだ
薗部	そのべ
薩摩	さつま
薬師寺	やくしじ
薮本	やぶもと
藤	ふじ
藤﨑	ふじさき
藤代	ふじしろ
藤倉	ふじくら
藤堂	とうどう
藤宮	ふじみや
藤尾	ふじお
藤崎	ふじさき
藤巻	ふじまき
藤後	とうご
藤木	ふじき
藤村	ふじむら
藤枝	ふじえだ
藤江	ふじえ
藤田	ふじた
藤竹	ふじたけ
藤縄	ふじなわ
藤谷	ふじたに
藤野	ふじの
藪内	やぶうち
藪崎	やぶざき
蜷川	にながわ
蝦名	えびな
蟹江	かにえ
蟻田	ありた
街田	まちだ
衣笠	きぬがさ
袴田	はかまだ
西	にし
西久保	にしくぼ
西井	にしい
西内	にしうち
西口	にしぐち
西垣	にしがき
西堀	にしぼり
西室	にしむろ
西尾	にしお
西岡	にしおか
西島	にしじま
西嶋	にしじま
西川	さいかわ
西方	にしかた
西本	にしもと
西条	さいじょう
西森	にしもり
西澤	にしざわ
西牧	にしまき
西田	にしだ
西畑	にしはた
西谷	にしたに
西部	にしべ
西野	にしの
見岳	みたけ
見崎	みさき
見目	けんもく
観月	みづき
角	かど
角川	かどかわ
角替	つのがえ
角田	かくた
角田	かくだ
角田	すみた
角田	つのだ
角谷	かくたに
角野	かくの
角野	すみの
角銅	かくどう
設楽	したら
設楽	しだら
許斐	このみ
諸井	もろい
諸澤	もろさわ
護	もり
谷	たに
谷内	たにうち
谷内	やち
谷口	たにぐち
谷山	たにやま
谷岡	たにおか
谷川	たにかわ
谷川	たにがわ
谷本	たにもと
谷松	たにまつ
谷津	やつ
谷田川	やたがわ
豊岡	とよおか
豊嶋	としま
豊田	とよた
豊田	とよだ
貝原	かいはら
貝塚	かいづか
貞廣	さだひろ
財前	ざいぜん
財満	ざいま
赤﨑	あかさき
赤井	あかい
赤坂	あかさか
赤塚	あかつか
赤星	あかぼし
赤松	あかまつ
赤林	あかばやし
赤池	あかいけ
赤沼	あかぬま
赤田	あかた
赤田	あかだ
赤石	あかいし
赤羽	あかばね
赤間	あかま
越智	おち
足利	あしかが
足立	あだち
足達	あだち
車谷	くるまたに
軽部	かりべ
辰巳	たつみ
辻井	つじい
辻本	つじもと
辻村	つじむら
辻森	つじもり
辻田	つじた
辻野	つじの
込山	こみやま
近江谷	おうみや
近江谷	おおみや
近野	こんの
速水	はやみ
速水	はやみず
逢坂	おうさか
逢坂	おおさか
逢沢	あいざわ
進藤	しんどう
道上	みちがみ
道川	みちかわ
道木	どうき
道脇	みちわき
遠山	とおやま
那須	なす
郡司	ぐんじ
郷美	さとみ
都並	つなみ
都丸	とまる
都筑	つづき
都築	つずき
都築	つづき
酒巻	さかまき
里	さと
里中	さとなか
里見	さとみ
重友	しげとも
重松	しげまつ
重田	しげた
重盛	しげもり
重藤	しげふじ
野上	のがみ
野仲	のなか
野元	のもと
野原	のはら
野原	のばら
野口	のぐち
野呂	のろ
野地	のじ
野坂	のさか
野島	のじま
野明	のあけ
野木	のぎ
野本	のもと
野沢	のざわ
野溝	のみぞ
野澤	のざわ
野瀬	のせ
野間	のま
金井	かない
金原	かなはら
金城	かねしろ
金城	きんじょう
金子	かねこ
金山	かなやま
金森	かなもり
金田	かなだ
金田	かねだ
金野	こんの
釘町	くぎまち
釜萢	かまやち
釜萢	かまやつ
鈴江	すずえ
錦織	にしきおり
錦織	にしこり
鍵本	かぎもと
鎌田	かまた
鎌田	かまだ
鎌野	かまの
鎮西	ちんぜい
長	おさ
長	ちょう
長井	ながい
長坂	ながさか
長尾	ながお
長岐	ながき
長崎	ながさき
長束	なつか
長松	ながまつ
長江	ながえ
長沖	ながおき
長沢	ながさわ
長沼	ながぬま
長澤	ながさわ
長濱	ながはま
長瀬	ながせ
長谷	はせ
長谷川	はせがわ
長谷部	はせべ
長野	ながの
長門	ながと
門	かど
門井	かどい
門田	もんでん
門脇	かどわき
間	あいだ
間	はざま
間瀬	ませ
間野	まの
関口	せきぐち
関本	せきもと
関根	せきね
関田	せきた
関谷	せきや
關屋	せきや
阪井	さかい
阪口	さかぐち
阪本	さかもと
阪谷	さかたに
阿井	あい
阿川	あがわ
阿比留	あびる
阿波野	あわの
阿知波	あちは
阿達	あだち
降矢	ふるや
陣ノ內	じんのうち
陣内	じんない
陶山	すやま
陸奥	むつ
陸川	りくかわ
難波	なんば
雪田	ゆきた
雪野	ゆきの
靑野	あおの
青柳	あおやぎ
青沼	あおぬま
青野	あおの
鞍田	くらた
須山	すやま
須崎	すさき
須崎	すざき
須永	すなが
須田	すだ
須藤	すとう
須藤	すどう
須見	すみ
須賀	すか
須野田	すのだ
風見	かざみ
風間	かざま
飛田	とびた
飯塚	いいずか
飯塚	いいづか
飯尾	いいお
飯島	いいじま
飯村	いいむら
飯田	いいだ
飯野	いいの
香取	かとり
香山	かやま
香川	かがわ
香月	かげつ
香月	かつき
香村	こうむら
香田	こうだ
香野	こうの
馬上	もうえ
馬場	ばば
馬淵	まぶち
馬見塚	まみつか
駒木	こまき
駒沢	こまざわ
駒澤	こまざわ
駒野	こまの
高下	たかした
高井	たかい
高倉	たかくら
高原	たかはら
高口	たかぐち
高坂	たかさか
高城	たかぎ
高塚	たかつか
高塩	たかしお
高尾	たかお
高山	たかやま
高岡	たかおか
高岸	たかぎし
高島	たかしま
高嶋	たかしま
高本	たかもと
高村	こうむら
高村	たかむら
高松	たかまつ
高林	たかばやし
高柳	たかやなぎ
高桑	たかくわ
高梨	たかなし
高森	たかもり
高沢	たかざわ
高津	たかつ
高浜	たかはま
高澤	たかざわ
高瀬	たかせ
高畑	たかはた
高草木	たかくさき
高萩	たかはぎ
高見	たかみ
高見沢	たかみざわ
高谷	たかや
高部	たかべ
高野	こうの
髙井	たかい
髙崎	たかさき
髙畠	たかはた
鬼丸	おにまる
鬼塚	おにづか
鬼木	おにき
鬼頭	きとう
魚住	うおずみ
魚谷	うおたに
鮎川	あゆかわ
鮒子田	ふしだ
鮫島	さめじま
鳥塚	とりづか
鳥居	とりい
鳥山	とりやま
鳥海	とりうみ
鳥羽	とば
鳥羽	とりば
鳥谷	とりたに
鳥越	とりごえ
鳥飼	とりい
鳥飼	とりかい
鳳	ほう
鳴海	なるみ
鴫野	しぎの
鵜崎	うざき
鵜浦	うのうら
鵜澤	うざわ
鵜飼	うかい
鶴	つる
鶴岡	つるおか
鶴来	つるぎ
鶴橋	つるはし
鶴田	つるた
鶴田	つるだ
鷹野	たかの
鹿取	かとり
鹿島	かしま
鹿野	しかの
麦倉	むぎくら
麻倉	あさくら
黒井	くろい
黒子	くろこ
黒木	くろき
黒柳	くろやなぎ
黒澤	くろさわ
黒瀬	くろせ
黒田	くろだ
黒須	くろす
黛	まゆずみ
齊藤	さいとう
